11111111111111111111
10000000000000000000
10111100011100111101
10111111011101111101
10000001011101000001
10111101000000111101
10111101111110111101
10111101111110111101
10000000011000000001
10000011111111000001
10001111000011100001
10011111000011111001
10000011000011000001
10011000000000011001
10011111000011111001
10011111100111111001
10001111100111110001
10000111100111100001
10000000000000000001
11111111111111111111